                                               


                                                   %
                                                  %%%
                                                 %%%%%
                                                %%%%%%%
                                               %%%%%%%%%
                                              %%%%%%%%%%%
                                             %%%%%%%%%%%%%
                                            %%%%%%%%%%%%%%%
                                           %%%%%%%%%%%%%%%%%
                                          %%%%%%%%%%%%%%%%%%%
                                         %%%%%%%%%%%%%%%%%%%%%
                                        %%%%%%%%%%%%%%%%%%%%%%%                          %%%%%%%%%%%%%%%%
                                       %%%%%%%%%%%%%%%%%%%%%%%%%                        %%%%%%%%%%%%%%%%
                                                                                       %%%%%%%%%%%%%%%%                   
                  

                                                                                                                                      %%%%%%     %%%%%%
                                                                                                                                      %%%%%%     %%%%%%           
                                                                                                                                      %%%%%%     %%%%%%


                                                                                 
                                                  
                                                                         
                                                                   
                                                         